#  ######    #  
 #    # #### ## 
 ####        #  
  # # ####     #
 #  ###  # #####
 # # #   # ## !#
  #  # ###    ##
#   ## # ####   
  # #  #      # 
 ## # ### ## #  
 ##   #    #### 
 #########  # # 
       ### ## # 
### ###  # #  ##
  ### # #### ## 
@               
