               #
 # ###########!#
###      #######
 ###      #### #
 ####### #######
   ##### #######
## ########    #
##      ### ####
#######  ##    #
#   #      ###  
  #   ######## #
 ########    # 
        ###  ##
###  ####   ## 
    #     #  # #
@##   ######   #
