  ####    #####!
 ##   #  ##   # 
 # ##  ##   ### 
#  # ######   ##
# # ###  # #####
# #     ## ##  #
 #### #### #  # 
 #       #   ## 
  # #### ### #  
  #    #     #  
   # # ######   
   ###   #  #   
    #  #   #    
     ### ##     
      #@ #      
       ##       
