                
 ############## 
 #            # 
 # ########## # 
 # #        # # 
 # # ###### # # 
 # # #    # # # 
 # # # ## # # # 
 # # # # ## # # 
 # # # ##!# # # 
 # # # #### # # 
 # # #      # # 
 # # ######## # 
 # #          # 
 # ############ 
@#              
