    ####      #!
    ##        ##
##       #     #
 ###     ####   
   ####   #   ##
      #     #  #
    ####   ##   
    ##    ###   
##    ####      
#    ##     ##  
#    #     ##  #
     ###  ##   #
   ###  ##      
#           ### 
##########      
@          #####
