! #   #####   ##
#  ###   #   ###
#   ###  ## #  #
###         ##  
  ##   ###   #  
###   ##    ### 
#   ######     #
##    ##    #  #
##   ##   ##    
#      #    ### 
  ###    ###  # 
###   ####    # 
#    ##     ##  
####      ##   #
#######  #    ##
@            ###
