################
#              #
#              #
#              #
#              #
#  ##### ##### #
#  #     #     #
#  #   # #   # #
#  #   # #   # #
#  ##### ##### #
#              #
#              #
#              #
#              #
#@             #
################
